application-7zip	application-x-7zip
application-atom+xml	application-rss+xml
application-illustrator	x-office-drawing
application-javascript	text-x-javascript
application/javascript	text-x-script
application-magicpoint	x-office-presentation
application-mbox	message
application-msword	application-msword
application-octet-stream	multipart-encrypted
application-ogg	audio-x-vorbis+ogg
application-pdf	application-pdf
application-pgp-encrypted	encrypted
application-pkcs7-mime	application-pgp-keys
application-postscript	text-richtext
application-rss+xml	application-rss+xml
application-rtf	text-richtext
application-text	text-plain
application-vnd.debian.binary-package	package-x-generic
application-vnd.lotus-1-2-3	x-office-spreadsheet
application-vnd.ms-access	text-x-sql
application-vnd.ms-excel	application-vnd.ms-excel
application-vnd.oasis.opendocument.database	text-x-sql
application-vnd.oasis.opendocument.formula	application-vnd.oasis.opendocument.formula
application-vnd.oasis.opendocument.graphics	x-office-drawing
application-vnd.oasis.opendocument.image	x-office-drawing
application-vnd.oasis.opendocument.presentation	x-office-presentation
application-vnd.oasis.opendocument.spreadsheet	x-office-spreadsheet
application-vnd.oasis.opendocument.text-web	text-html
application-vnd.oasis.opendocument.text	x-office-document
application-vnd.openxmlformats-officedocument.presentationml.presentation	application-vnd.ms-powerpoint
application-vnd.openxmlformats-officedocument.presentationml.slideshow	application-vnd.ms-powerpoint
application-vnd.openxmlformats-officedocument.spreadsheetml.sheet	application-vnd.ms-excel
application-vnd.openxmlformats-officedocument.wordprocessingml.document	application-msword
application-vnd.rn-realmedia-secure	video-x-generic
application-vnd.rn-realmedia-vbr	video-x-generic
application-vnd.rn-realmedia	video-x-generic
application-vnd.scribus	application-vnd.scribus
application-vnd.stardivision.calc	x-office-spreadsheet
application-vnd.stardivision.impress	x-office-presentation
application-vnd.stardivision.writer	x-office-document
application-vnd.sun.xml.calc	x-office-spreadsheet
application-vnd.sun.xml.draw	x-office-drawing
application-vnd.sun.xml.impress	x-office-presentation
application-vnd.sun.xml.writer	x-office-document
application-vnd.wordperfect	x-office-document
application-wordperfect	x-office-document
application-x-7z-compressed	application-x-7zip
application-x-abiword	x-office-document
application-x-ace	application-x-ace
application-x-applix-spreadsheet	x-office-spreadsheet
application-x-applix-word	x-office-document
application-x-arc	application-x-archive
application-x-arj	application-x-archive
application-x-bittorrent	application-x-bittorrent
application-x-bzip	application-x-archive
application-x-bzip-compressed	application-x-archive
application-x-bzip-compressed-tar	application-x-archive
application-x-class-file	text-x-java
application-x-compress	application-x-archive
application-x-compressed-tar	application-x-gzip
application-x-cpio	application-x-archive
application-x-cpio-compressed	application-x-archive
application-x-csproj	application-x-sln
application-x-deb	deb
application-x-designer	application-x-glade
application-x-desktop	application-x-theme
application-x-dvi	x-office-document
application-x-executable	application-x-executable
application-x-extension-html	text-html
application-x-font-afm	font-x-generic
application-x-font-bdf	font-x-generic
application-x-font-linux-psf	font-x-generic
application-x-font-pcf	font-x-generic
application-x-font-sunos-news	font-x-generic
application-x-font-ttf	font-x-generic
application-x-glade	application-x-glade
application-x-gnome-app-info	application-x-theme
application-x-gnome-theme-package	application-x-theme
application-x-gnumeric	x-office-spreadsheet
application-x-gzip	application-x-gzip
application-x-gzpostscript	text-richtext
application-x-java-archive	application-x-jar
application-x-keepass	application-pgp-keys
application-x-killustrator	image-x-generic
application-x-kpresenter	x-office-presentation
application-x-kspread	x-office-spreadsheet
application-x-kword	x-office-document
application-x-lha	application-x-archive
application-x-lhz	application-x-archive
application-x-m4	text-richtext
application-x-matroska	video-x-generic
application-xml	text-xml
application-x-ms-dos-executable	application-x-ms-dos-executable
application-x-ole-storage	multipart-encrypted
application-x-pak	package-x-generic
application-x-pem-key	application-pgp-keys
application-x-php	application-x-php
application-x-python-bytecode	text-x-python
application-x-rpm	rpm
application-x-scribus	application-vnd.scribus
application-x-shellscript	text-x-script
application-x-shockwave-flash	application-x-flash-video
application-x-sql	text-x-sql
application-x-sqlite2	text-x-sql
application-x-sqlite3	text-x-sql
application-x-stuffit	application-x-archive
application-x-tarz	application-x-archive
application-x-tex	text-x-tex
application-x-trash	text-x-bak
application-zip	application-x-zip
audio-mpeg	audio-x-mpeg
audio-x-adpcm	audio-x-wav
audio-x-flac+ogg	audio-x-vorbis+ogg
audio-x-mpegurl	audio-x-mp3-playlist
audio-x-scpls	audio-x-mp3-playlist
audio-x-speex+ogg	audio-x-vorbis+ogg
image-jpeg2000	image-jpeg
image-jpeg	image-jpeg
image-svg+xml	x-office-drawing
image-vnd.microsoft.icon	image-x-ico
image-x-icon	image-x-ico
image-x-portable-bitmap	image-bmp
image-x-psdimage-x-psd	image-x-psd
image-x-svg+xml	x-office-drawing
image-x-win-bitmap	image-bmp
media-audio	audio-x-generic
media-image	image-x-generic
media-video	video-x-generic
message-rfc822	message
playlist-automatic	text-x-makefile
source-playlist	audio-x-mp3-playlist
source-smart-playlist	text-x-makefile
text-calendar	vcalendar
text-csv	x-office-spreadsheet
text-enriched	text-richtext
text-htmlh	text-html
text-htm	text-html
text-spreadsheet	x-office-spreadsheet
text-vnd.wap.wml	text-html
text-x-authors	authors
text-x-c++hdr	text-x-csrc
text-x-chdr	text-x-csrc
text-x-credits	authors
text-x-csharp	text-x-csrc
text-x-csharp	text-x-source
text-x-csh	text-x-script
text-x-c++src.png                     	text-x-csrc
text-x-c++src	text-x-c++
text-x-csrc	text-x-c
text-x-css	text-css
text-x-generic	text-plain
text-x-gtkrc	application-x-theme
text-x-install	text-x-script
text-x-java-source	text-x-java
text-x-makefile	text-x-source
text-x-php	application-x-php
text-x-preview	empty
text-x-sh	text-x-script
text-x-source	text-x-source
text-x-vcalendar	vcalendar
text-x-zsh	text-x-script
x-font-afm	font-x-generic
x-install	text-x-install
